level1: Array [0..79] of byte = 
	(1,2,3,2,3,2,3,4,5,6,
	5,6,5,6,5,6,11,16,17,11,
	12,12,13,14,21,14,13,14,13,22,
	13,14,18,19,13,15,15,15,15,15,
	5,6,5,6,5,6,5,6,5,6,
	13,14,13,14,13,14,13,14,13,14,
	16,17,18,19,20,11,16,17,18,19,
	1,2,3,4,5,6,5,6,5,6);
